Taxon_name	Attribute
Cellvibrio	aerobic
Methylophilus	aerobic
Pelobacter	anaerobic
Phenylobacterium	aerobic
Shewanella 	facultatively anaerobic
Vitreoscilla 	aerobic
Lysobacter	aerobic
Simonsiella	aerobic
Hyphomonas	aerobic
Stella	aerobic
Gallionella	anaerobic
Flectobacillus	aerobic
Runella	aerobic
Spirosoma	aerobic
Gemmata	aerobic
Methylocystis	aerobic
Spirochaeta 	facultatively anaerobic
Treponema	anaerobic
Leptospira	aerobic
Aquaspirillum 	aerobic
Alteromonas	aerobic
Brucella	aerobic
Francisella	aerobic
Paracoccus 	aerobic
Thermus 	aerobic
Xanthobacter	anaerobic
Comamonas	aerobic
Pseudomonas 	aerobic
Serpens	aerobic
Zoogloea	aerobic
Azotobacter 	aerobic
Agrobacterium 	aerobic
Agromonas 	aerobic
Bradyrhizobium	aerobic
Allorhizobium	aerobic
Rhizobium	aerobic
Methylobacillus	aerobic
Methylobacterium	aerobic
Methylococcus	aerobic
Methylomonas	aerobic
Methylosinus	aerobic
Methylobacter	aerobic
Legionella	aerobic
Acinetobacter	aerobic
Moraxella 	aerobic
Neisseria	aerobic
Psychrobacter	aerobic
Bordetella	aerobic
Acidiphilium	aerobic
Beijerinckia 	aerobic
Eikenella 	facultatively anaerobic
Zymomonas 	facultatively anaerobic
Citrobacter	facultatively anaerobic
Enterobacter	facultatively anaerobic
Erwinia 	facultatively anaerobic
Escherichia 	aerobic
Escherichia 	facultatively anaerobic
Hafnia	facultatively anaerobic
Klebsiella	facultatively anaerobic
Kluyvera	facultatively anaerobic
Morganella	facultatively anaerobic
Proteus	facultatively anaerobic
Providencia	facultatively anaerobic
Salmonella	facultatively anaerobic
Serratia 	facultatively anaerobic
Shigella	facultatively anaerobic
Xenorhabdus	facultatively anaerobic
Yersinia	facultatively anaerobic
Edwardsiella	facultatively anaerobic
Aeromonas	facultatively anaerobic
Photobacterium	anaerobic
Plesiomonas	facultatively anaerobic
Actinobacillus 	facultatively anaerobic
Haemophilus 	aerobic
Haemophilus 	facultatively anaerobic
Pasteurella 	aerobic
Pasteurella 	facultatively anaerobic
Bacteroides	anaerobic
Butyrivibrio	anaerobic
Prevotella	anaerobic
Xylanibacter	anaerobic
Roseburia	anaerobic
Oxalobacter	anaerobic
Syntrophomonas	anaerobic
Syntrophospora	anaerobic
Dichelobacter	anaerobic
Desulfuromonas	anaerobic
Desulfobulbus	anaerobic
Desulfococcus	anaerobic
Desulfomicrobium	anaerobic
Acidaminococcus	anaerobic
Megasphaera	anaerobic
Nitrobacter 	aerobic
Thiobacillus	anaerobic
Thiomicrospira	aerobic
Hydrogenobacter	aerobic
Bdellovibrio	aerobic
Oceanospirillum	aerobic
Selenomonas	anaerobic
Sporohalobacter	anaerobic
Cytophaga	aerobic
Flexibacter 	aerobic
Flexibacter 	facultatively anaerobic
Saprospira	aerobic
Sporocytophaga	aerobic
Weeksella	aerobic
Capnocytophaga 	facultatively anaerobic
Beggiatoa 	aerobic
Microscilla	aerobic
Rhodobacter	aerobic
Chloroflexus	anaerobic
Porphyrobacter	aerobic
Nitrospira	aerobic
Piscirickettsia	aerobic
Ruminococcus	anaerobic
Micrococcus	aerobic
Deinococcus	aerobic
Streptococcus	facultatively anaerobic
Enterococcus	facultatively anaerobic
Lactococcus	facultatively anaerobic
Marinococcus	aerobic
Planococcus	aerobic
Aerococcus	facultatively anaerobic
Gemella	facultatively anaerobic
Atopobium	facultatively anaerobic
Bacillus	anaerobic
Desulfotomaculum	anaerobic
Clavibacter	aerobic
Paralactobacillus 	aerobic
Paralactobacillus 	facultatively anaerobic
Listeria 	facultatively anaerobic
Erysipelothrix	facultatively anaerobic
Alloiococcus	aerobic
Bifidobacterium 	anaerobic
Brevibacterium	aerobic
Cellulomonas 	aerobic
Corynebacterium 	aerobic
Thermodesulfobacterium	anaerobic
Propionibacterium 	anaerobic
Mycobacterium	aerobic
Amycolatopsis 	facultatively anaerobic
Nocardia	aerobic
Rhodococcus	aerobic
Saccharopolyspora	aerobic
Nocardioides	aerobic
Pseudonocardia	aerobic
Actinopolyspora	aerobic
Saccharomonospora	aerobic
Frankia 	aerobic
Dermatophilus 	facultatively anaerobic
Micromonospora	aerobic
Streptomyces	aerobic
Actinomadura	aerobic
Microtetraspora	aerobic
Planomonospora	aerobic
Streptosporangium	aerobic
Microbispora	aerobic
Nocardiopsis	aerobic
Streptoalloteichus	aerobic
Thermomonospora	aerobic
Thermoactinomyces	aerobic
Kibdelosporangium	aerobic
Curtobacterium	aerobic
Tropheryma 	aerobic
Aeromicrobium	aerobic
Mobiluncus	anaerobic
Gordonia	aerobic
Tsukamurella	aerobic
Saccharothrix	aerobic
Sporolactobacillus	facultatively anaerobic
Mycoplasma 	aerobic
Mycoplasma 	facultatively anaerobic
Spiroplasma	facultatively anaerobic
Acholeplasma	facultatively anaerobic
Methanobacterium	anaerobic
Methanothermus	anaerobic
Methanocorpusculum	anaerobic
Methanogenium	anaerobic
Methanospirillum	anaerobic
Methanomicrobium	anaerobic
Methanosarcina	anaerobic
Methanolobus	anaerobic
Methanococcoides	anaerobic
Archaeoglobus	anaerobic
Haloarcula 	facultatively anaerobic
Halobacterium	facultatively anaerobic
Halococcus	aerobic
Haloferax 	aerobic
Natronobacterium	aerobic
Pyrococcus	anaerobic
Thermococcus	anaerobic
Pyrobaculum 	anaerobic
Pyrobaculum 	facultatively anaerobic
Staphylothermus	anaerobic
Desulfobacter	anaerobic
Desulfobacterium	anaerobic
Desulfosarcina	anaerobic
Thermoplasma 	facultatively anaerobic
Pyrodictium	anaerobic
Methanoplanus	anaerobic
Methanosphaera	anaerobic
Methanohalobium	anaerobic
Halanaerobium	anaerobic
Propionigenium	anaerobic
Haliscomenobacter	aerobic
Flexistipes	anaerobic
Desulfomonile	anaerobic
Xylella	aerobic
Acetonema	anaerobic
Sporomusa	anaerobic
Gardnerella	facultatively anaerobic
Aquifex	facultatively anaerobic
Cardiobacterium 	facultatively anaerobic
Hirschia	aerobic
Symbiobacterium	facultatively anaerobic
Verrucomicrobium 	facultatively anaerobic
Vagococcus	facultatively anaerobic
Peptococcus	anaerobic
Marinobacter 	aerobic
Halomonas	anaerobic
Carnobacterium	facultatively anaerobic
Synergistes	anaerobic
Brochothrix 	aerobic
Acidianus 	facultatively anaerobic
Acidovorax	aerobic
Globicatella	facultatively anaerobic
Rarobacter 	facultatively anaerobic
Suttonella 	aerobic
Anaerobiospirillum	anaerobic
Sphingomonas 	aerobic
Sulfobacillus 	aerobic
Lachnospira	anaerobic
Phyllobacterium	aerobic
Sinorhizobium	aerobic
Rikenella	anaerobic
Acetohalobium	anaerobic
Thermonema	aerobic
Desulfobacula	anaerobic
Colwellia	facultatively anaerobic
Geotoga	anaerobic
Petrotoga	anaerobic
Marinomonas	aerobic
Thermodesulfovibrio	anaerobic
Arcanobacterium	facultatively anaerobic
Herbidospora	aerobic
Hydrogenovibrio	aerobic
Natronococcus	aerobic
Planobispora	aerobic
Alicyclobacillus	aerobic
Amphibacillus 	facultatively anaerobic
Dolosigranulum	facultatively anaerobic
Saccharococcus	aerobic
Microlunatus 	aerobic
Veillonella	anaerobic
Photorhabdus	facultatively anaerobic
Syntrophobacter	anaerobic
Rhodothermus	aerobic
Janthinobacterium	aerobic
Aminobacter	aerobic
Burkholderia 	aerobic
Leptotrichia 	aerobic
Sebaldella	anaerobic
Kingella 	aerobic
Kingella 	facultatively anaerobic
Halothermothrix	anaerobic
Thauera	aerobic
Zymobacter	facultatively anaerobic
Catenuloplanes	aerobic
Agromyces	aerobic
Microbacterium	aerobic
Acetobacterium	anaerobic
Melissococcus 	anaerobic
Caryophanon	aerobic
Kineococcus	aerobic
Luteococcus	facultatively anaerobic
Exiguobacterium	facultatively anaerobic
Acidomonas	aerobic
Rhodovulum	aerobic
Rahnella	facultatively anaerobic
Telluria	aerobic
Variovorax	aerobic
Riemerella 	aerobic
Filibacter	aerobic
Streptobacillus 	aerobic
Streptobacillus 	anaerobic
Sporichthya	facultatively anaerobic
Dactylosporangium	aerobic
Nitrococcus	aerobic
Nitrospina	aerobic
Bilophila	anaerobic
Desulfacinum	anaerobic
Holophaga	anaerobic
Dermabacter	facultatively anaerobic
Desulfuromusa	anaerobic
Dietzia	aerobic
Thermocrispum	aerobic
Blastococcus	aerobic
Methylomicrobium	aerobic
Desulforhabdus	anaerobic
Actinokineospora	aerobic
Oligotropha	aerobic
Stenotrophomonas	aerobic
Desulforhopalus	anaerobic
Actinosynnema	aerobic
Succiniclasticum	anaerobic
Ewingella	facultatively anaerobic
Chromohalobacter	aerobic
Spirilliplanes	aerobic
Halobacteroides	anaerobic
Halanaerobacter	anaerobic
Ammonifex	anaerobic
Kutzneria	aerobic
Promicromonospora	aerobic
Syntrophus	anaerobic
Halobaculum 	aerobic
Caldicellulosiruptor	anaerobic
Paenibacillus 	aerobic
Paenibacillus 	facultatively anaerobic
Oxalophagus	anaerobic
Leucothrix	aerobic
Desulfonema	anaerobic
Desulfohalobium	anaerobic
Salinicoccus	aerobic
Methanoculleus	anaerobic
Geovibrio	anaerobic
Pseudobutyrivibrio	anaerobic
Oenococcus	facultatively anaerobic
Weissella	facultatively anaerobic
Orenia	anaerobic
Devosia	aerobic
Dethiosulfovibrio	anaerobic
Hydrogenophaga	aerobic
Pedomicrobium	aerobic
Lautropia	aerobic
Microbulbifer	aerobic
Marinobacterium	aerobic
Thermothrix	aerobic
Ralstonia 	aerobic
Kineosporia	aerobic
Psychroserpens	aerobic
Gelidibacter	aerobic
Acetomicrobium	anaerobic
Anaerobaculum	anaerobic
Acidocella	aerobic
Acidisphaera	aerobic
Desulfofustis	anaerobic
Syntrophobotulus	anaerobic
Tetragenococcus	facultatively anaerobic
Natroniella	anaerobic
Polaribacter	aerobic
Polaromonas	aerobic
Desulfonatronovibrio	anaerobic
Pseudoalteromonas 	aerobic
Desulfocapsa	anaerobic
Desulfospira	anaerobic
Pantoea	facultatively anaerobic
Terrabacter	aerobic
Intrasporangium	aerobic
Catellatospora	aerobic
Pilimelia	aerobic
Friedmanniella	aerobic
Lonepinella	facultatively anaerobic
Sulfophobococcus	anaerobic
Pfennigia 	facultatively anaerobic
Propioniferax 	facultatively anaerobic
Janibacter	aerobic
Humicoccus	aerobic
Nakamurella	aerobic
Deferribacter	anaerobic
Acidimicrobium	aerobic
Octadecabacter 	aerobic
Methylosphaera	aerobic
Pyrolobus 	facultatively anaerobic
Ignicoccus	anaerobic
Ferroglobus	anaerobic
Aneurinibacillus	aerobic
Brevibacillus 	aerobic
Schwartzia	anaerobic
Bogoriella 	aerobic
Dehalobacter	anaerobic
Couchioplanes	aerobic
Aeropyrum	aerobic
Amaricoccus	aerobic
Malonomonas	anaerobic
Microvirgula 	aerobic
Kocuria 	aerobic
Nesterenkonia	aerobic
Dermacoccus	aerobic
Kytococcus	aerobic
Vogesella	aerobic
Moritella	facultatively anaerobic
Actinocorallia	aerobic
Glycomyces	aerobic
Planotetraspora	aerobic
Spirillospora	aerobic
Sagittula	aerobic
Skermania	aerobic
Epilithonimonas	aerobic
Kaistella	aerobic
Sejongia 	aerobic
Empedobacter	aerobic
Bergeyella	aerobic
Marinilabilia	facultatively anaerobic
Flammeovirga	aerobic
Persicobacter	facultatively anaerobic
Alcanivorax 	aerobic
Staleya	aerobic
Halogeometricum 	aerobic
Halosarcina	aerobic
Desulfobacca	anaerobic
Holdemania	anaerobic
Methylorhabdus	aerobic
Thermocladium 	anaerobic
Natronomonas	aerobic
Demetria 	aerobic
Nevskia	aerobic
Carnimonas	aerobic
Marinospirillum	aerobic
Acidaminobacter	anaerobic
Actinoalloteichus	aerobic
Cryptosporangium	aerobic
Virgisporangium	aerobic
Meiothermus	aerobic
Facklamia	facultatively anaerobic
Desulfonatronum	anaerobic
Ammoniphilus	aerobic
Sporotomaculum	anaerobic
Mesorhizobium	aerobic
Cyclobacterium	aerobic
Coprothermobacter	anaerobic
Terracoccus	aerobic
Defluvibacter	aerobic
Cryobacterium	aerobic
Sulfurisphaera	facultatively anaerobic
Azomonas	aerobic
Macrococcus	facultatively anaerobic
Hydrogenophilus	aerobic
Flexithrix	aerobic
Lewinella	aerobic
Brenneria 	facultatively anaerobic
Methylarcula	aerobic
Citromicrobium 	anaerobic
Tessaracoccus	facultatively anaerobic
Dechloromonas	facultatively anaerobic
Roseovarius	aerobic
Antarctobacter	aerobic
Ferroplasma 	facultatively anaerobic
Rhodanobacter	aerobic
Duganella	aerobic
Balneatrix	aerobic
Neptunomonas	aerobic
Mannheimia	facultatively anaerobic
Thermobacillus	aerobic
Mycetocola	aerobic
Myroides	aerobic
Actinobaculum 	anaerobic
Caldivirga	anaerobic
Craurococcus 	aerobic
Succinispira	anaerobic
Alterococcus 	facultatively anaerobic
Desulfosporosinus	anaerobic
Chitinophaga	aerobic
Denitrobacterium	anaerobic
Delftia	aerobic
Aminomonas	anaerobic
Aminobacterium	anaerobic
Methylovorus	aerobic
Centipeda	anaerobic
Ornithinicoccus 	aerobic
Trichococcus	aerobic
Buttiauxella	facultatively anaerobic
Leminorella	facultatively anaerobic
Obesumbacterium	facultatively anaerobic
Pragia	facultatively anaerobic
Tatumella	facultatively anaerobic
Psychroflexus	aerobic
Luteimonas	aerobic
Pseudoxanthomonas	aerobic
Leclercia	facultatively anaerobic
Desulfonispora	anaerobic
Thermobifida	aerobic
Nonomuraea	aerobic
Propionibacter	anaerobic
Propionivibrio	anaerobic
Succinivibrio	anaerobic
Palaeococcus	facultatively anaerobic
Propionispira	anaerobic
Zymophilus	anaerobic
Syntrophococcus	anaerobic
Virgibacillus 	aerobic
Pedobacter	aerobic
Verrucosispora	aerobic
Beutenbergia 	aerobic
Williamsia	aerobic
Bosea	aerobic
Mogibacterium	anaerobic
Marmoricola	aerobic
Modestobacter	aerobic
Thermodesulforhabdus	anaerobic
Ferribacterium	anaerobic
Ignavigranum	facultatively anaerobic
Desulfocella	anaerobic
Glaciecola	aerobic
Rubrimonas 	aerobic
Hymenobacter 	aerobic
Oligella	aerobic
Asaia	aerobic
Pseudaminobacter	aerobic
Roseivivax 	aerobic
Ruegeria	aerobic
Tetrasphaera	aerobic
Alkalibacterium	facultatively anaerobic
Sporobacterium	anaerobic
Papillibacter	anaerobic
Collinsella	anaerobic
Oscillochloris 	anaerobic
Streptomonospora	aerobic
Cellulophaga	aerobic
Tenacibaculum	aerobic
Ensifer 	aerobic
Desulfofrigus	anaerobic
Desulfotalea	anaerobic
Desulfofaba	anaerobic
Pelospora	anaerobic
Anaerovorax	anaerobic
Alishewanella	facultatively anaerobic
Muricauda 	aerobic
Muricauda 	facultatively anaerobic
Schineria	aerobic
Zobellia	aerobic
Propionispora	anaerobic
Pseudoramibacter	anaerobic
Alkaliphilus 	anaerobic
Parasporobacterium	anaerobic
Desulfotignum	anaerobic
Micropruina	anaerobic
Actinopolymorpha	aerobic
Granulicatella	facultatively anaerobic
Chrysiogenes	anaerobic
Anaerorhabdus	anaerobic
Filomicrobium	aerobic
Rhodobaca	aerobic
Acidithiobacillus	aerobic
Subtercola	aerobic
Salana 	facultatively anaerobic
Dyadobacter	aerobic
Roseinatronobacter	aerobic
Haloterrigena	aerobic
Pectobacterium	facultatively anaerobic
Solobacterium	anaerobic
Roseomonas	aerobic
Ornithinimicrobium 	aerobic
Geobacillus 	aerobic
Crossiella	aerobic
Natronorubrum	aerobic
Knoellia 	aerobic
Atopobacter	facultatively anaerobic
Thermacetogenium	anaerobic
Lachnobacterium	anaerobic
Thermomonas	aerobic
Prauserella	aerobic
Isobaculum	facultatively anaerobic
Selenihalanaerobacter	anaerobic
Salegentibacter	aerobic
Methanothermobacter	anaerobic
Halorhabdus 	aerobic
Halorhabdus 	facultatively anaerobic
Azonexus	aerobic
Azospira	aerobic
Thermobispora	aerobic
Massilia	aerobic
Desulfovirga	anaerobic
Halonatronum	anaerobic
Blastomonas 	aerobic
Erythromonas 	aerobic
Roseibium 	aerobic
Starkeya	aerobic
Stappia	aerobic
Ahrensia	aerobic
Aequorivita	aerobic
Vitellibacter	aerobic
Georgenia 	facultatively anaerobic
Anaeroglobus	anaerobic
Thioalkalicoccus	anaerobic
Dysgonomonas	facultatively anaerobic
Reichenbachiella	aerobic
Jeotgalibacillus	facultatively anaerobic
Cellulosimicrobium	facultatively anaerobic
Hahella	facultatively anaerobic
Cedecea	facultatively anaerobic
Moellerella	facultatively anaerobic
Trabulsiella	facultatively anaerobic
Yokenella	facultatively anaerobic
Thermovenabulum	anaerobic
Ureibacillus	aerobic
Methylosarcina	aerobic
Planomicrobium	aerobic
Oerskovia 	facultatively anaerobic
Lentzea	aerobic
Sphingopyxis	aerobic
Anaerococcus	anaerobic
Sporanaerobacter	anaerobic
Caminicella	anaerobic
Lechevalieria	aerobic
Ilyobacter	anaerobic
Sneathia	anaerobic
Citricoccus	aerobic
Caloranaerobacter	anaerobic
Halosimplex	aerobic
Eremococcus	facultatively anaerobic
Dolosicoccus	facultatively anaerobic
Victivallis	anaerobic
Gemmatimonas	aerobic
Allobaculum	anaerobic
Anaerophaga	anaerobic
Opitutus	anaerobic
Arenibacter	aerobic
Smithella	anaerobic
Kribbella 	aerobic
Oceanobacillus 	aerobic
Oceanobacillus 	anaerobic
Macromonas	aerobic
Varibaculum	facultatively anaerobic
Methylocapsa	aerobic
Xylanimonas 	aerobic
Xylanimonas 	facultatively anaerobic
Gelria	anaerobic
Plantibacter	aerobic
Sedimentibacter	anaerobic
Turicibacter	anaerobic
Pelotomaculum	anaerobic
Conexibacter	aerobic
Marinilactibacillus	facultatively anaerobic
Allofustis	facultatively anaerobic
Rhodoglobus	aerobic
Alysiella	aerobic
Asanoa	aerobic
Scardovia	anaerobic
Parascardovia	anaerobic
Caldisphaera	anaerobic
Brumimicrobium 	facultatively anaerobic
Meniscus	anaerobic
Paraliobacillus 	facultatively anaerobic
Thermanaeromonas	anaerobic
Propionimicrobium	anaerobic
Halobiforma	aerobic
Longispora	aerobic
Derxia 	aerobic
Skermanella	facultatively anaerobic
Dichotomicrobium 	aerobic
Seliberia	aerobic
Anaerostipes	anaerobic
Solirubrobacter	aerobic
Allisonella	anaerobic
Anoxynatronum	anaerobic
Kineosphaera	aerobic
Mesophilobacter	aerobic
Rhizobacter	aerobic
Rugamonas 	aerobic
Enhydrobacter 	facultatively anaerobic
Tepidibacter	anaerobic
Croceibacter	aerobic
Arcicella	aerobic
Kordia	aerobic
Yaniella	aerobic
Formosa 	aerobic
Thermodesulfobium	anaerobic
Cerasibacillus	aerobic
Xylanibacterium 	aerobic
Xylanibacterium 	facultatively anaerobic
Methanolacinia	anaerobic
Mesonia	aerobic
Belliella	aerobic
Salinibacterium	aerobic
Propionicimonas 	facultatively anaerobic
Fastidiosipila	anaerobic
Ulvibacter	aerobic
Akkermansia	anaerobic
Aeriscardovia 	anaerobic
Hespellia	anaerobic
Anaerotruncus	anaerobic
Methylohalobius	aerobic
Gillisia	aerobic
Crocinitomix	aerobic
Algoriphagus	aerobic
Cryomorpha	aerobic
Bryantella	anaerobic
Marvinbryantia	anaerobic
Caldanaerobacter	anaerobic
Maribacter	aerobic
Natronolimnobius	aerobic
Myceligenerans	aerobic
Soehngenia	anaerobic
Isoptericola	facultatively anaerobic
Pseudoclavibacter	aerobic
Lentisphaera	aerobic
Millisia	aerobic
Anaerofustis	anaerobic
Blastopirellula	aerobic
Rhodopirellula	aerobic
Oribacterium	anaerobic
Serinicoccus	aerobic
Arsenicicoccus	facultatively anaerobic
Owenweeksia	aerobic
Atopococcus	aerobic
Alkalibacter	anaerobic
Thermincola	anaerobic
Aquiflexum	aerobic
Jiangella	aerobic
Leeuwenhoekiella	aerobic
Bizionia	aerobic
Stackebrandtia	aerobic
Winogradskyella	aerobic
Alkaliflexus	anaerobic
Tenuibacillus	aerobic
Segniliparus	aerobic
Yeosuana	aerobic
Pontibacillus	aerobic
Xylanimicrobium	anaerobic
Aquimarina	aerobic
Roseivirga	aerobic
Cryptanaerobacter	anaerobic
Subsaximicrobium	aerobic
Subsaxibacter	aerobic
Lacinutrix	aerobic
Acaricomes	aerobic
Atopostipes	facultatively anaerobic
Subdoligranulum	anaerobic
Laceyella	aerobic
Thermoflavimicrobium	aerobic
Seinonella	aerobic
Gramella	aerobic
Chthoniobacter	aerobic
Terrimonas	aerobic
Adhaeribacter	aerobic
Lactovum	anaerobic
Halolactibacillus 	aerobic
Petrimonas	anaerobic
Gaetbulibacter 	aerobic
Methylothermus	aerobic
Leadbetterella	aerobic
Sphaerisporangium	aerobic
Pontibacter	aerobic
Dokdonia	aerobic
Krokinobacter	aerobic
Cohnella	aerobic
Kribbia	facultatively anaerobic
Planifilum	aerobic
Fluviicola	aerobic
Larkinella	aerobic
Goodfellowiella	aerobic
Olleya	aerobic
Rhodonellum	aerobic
Microcella	aerobic
Polymorphospora	aerobic
Costertonia	aerobic
Wautersiella	aerobic
Oryzihumus	aerobic
Paludibacter	anaerobic
Propionicicella 	facultatively anaerobic
Krasilnikovia	aerobic
Luedemannella	aerobic
Yonghaparkia	aerobic
Lutibacter	aerobic
Thermopolyspora	aerobic
Rubritalea 	facultatively anaerobic
Patulibacter	aerobic
Donghaeana 	aerobic
Nonlabens	aerobic
Persicivirga	aerobic
Sandarakinotalea	aerobic
Stenothermobacter	aerobic
Aureispira	aerobic
Phycicoccus	aerobic
Flaviramulus	aerobic
Brooklawnia	facultatively anaerobic
Zhihengliuella	aerobic
Carbophilus	aerobic
Haloplanus	anaerobic
Edaphobacter 	aerobic
Puniceicoccus	facultatively anaerobic
Sediminicola	aerobic
Labedella	aerobic
Echinicola	aerobic
Actinocatenispora	aerobic
Terriglobus 	aerobic
Methanoregula	anaerobic
Aestuariimicrobium	aerobic
Lapillicoccus	aerobic
Actinomycetospora	aerobic
Haloactinospora	aerobic
Catenulispora	aerobic
Alloscardovia 	anaerobic
Metascardovia	facultatively anaerobic
Humibacter	aerobic
Desulfurivibrio	anaerobic
Fodinicola	aerobic
Moryella	anaerobic
Fabibacter	aerobic
Frondihabitans	aerobic
Granulicoccus	facultatively anaerobic
Pelagicoccus 	facultatively anaerobic
Iamia	aerobic
Shimazuella	aerobic
Mechercharimyces	aerobic
Nitrososphaera	aerobic
Methanolinea	anaerobic
Cloacibacterium 	facultatively anaerobic
Acidiplasma	facultatively anaerobic
Desulfurispora	anaerobic
Microterricola	aerobic
Rhodoluna	aerobic
Acetofilamentum	anaerobic
Zhouia	aerobic
Methanocella	anaerobic
Umezawaea	aerobic
Ruania	aerobic
Marinactinospora	aerobic
Haloglycomyces	aerobic
Plantactinospora	aerobic
Serinibacter 	aerobic
Serinibacter 	anaerobic
Halogranum	aerobic
Methylovulum	aerobic
Phytohabitans	aerobic
Euzebya	aerobic
Angustibacter 	facultatively anaerobic
Yimella 	aerobic
Natronoarchaeum 	aerobic
Miniimonas	facultatively anaerobic
Halopelagius	aerobic
Kistimonas 	aerobic
Kistimonas 	facultatively anaerobic
Trueperella 	facultatively anaerobic
Halorussus	aerobic
Halobellus	aerobic
Halorientalis	aerobic
Halolamina	aerobic
Salarchaeum	aerobic
Acidicapsa 	aerobic
Alpinimonas 	aerobic
Methyloferula	aerobic
Methylovirgula	aerobic
Defluviitalea	anaerobic
Rugosimonospora	aerobic
Haloactinopolyspora	aerobic
Methylomarinum	aerobic
Compostimonas	aerobic
Halorubellus	aerobic
Salinarchaeum	aerobic
Methylorosula	aerobic
Methylogaea	aerobic
Haloactinobacterium	facultatively anaerobic
Xiangella	aerobic
Haloechinothrix	aerobic
Phytomonospora	aerobic
Pontimonas	aerobic
Methylomarinovum	aerobic
Rhizocola	aerobic
Halapricum 	aerobic
Methyloprofundus	aerobic
Diaminobutyricibacter	aerobic
Salinigranum	aerobic
Salinirubrum	aerobic
Canibacter	facultatively anaerobic
Homoserinibacter	aerobic
Natribaculum	aerobic
Melghiribacillus	aerobic
Fermentibacillus	anaerobic
Acetatifactor	anaerobic
Acidipila	aerobic
Acutalibacter	anaerobic
Aidingimonas	facultatively anaerobic
Albidovulum	aerobic
Alkalicoccus	aerobic
Amnibacterium	aerobic
Anaerobium	anaerobic
Anaerocolumna	anaerobic
Anaerolinea	anaerobic
Anaerosalibacter	anaerobic
Aquibacillus	aerobic
Aquicella	aerobic
Arenicella	aerobic
Arenimicrobium	aerobic
Aridibacter	aerobic
Auraticoccus	aerobic
Baia	aerobic
Bauldia	aerobic
Bellilinea 	aerobic
Blastocatella	aerobic
Brevitalea	aerobic
Brockia	anaerobic
Bryobacter	aerobic
Bryocella	aerobic
Caenibacillus	aerobic
Calderihabitans	anaerobic
Caldisericum	anaerobic
Caloribacterium	anaerobic
Caviibacter	anaerobic
Cecembia	aerobic
Celeribacter 	aerobic
Cognatishimia	aerobic
Compostibacillus	facultatively anaerobic
Conyzicola	aerobic
Crassaminicella	anaerobic
Croceifilum	aerobic
Cuneatibacter	anaerobic
Deinobacterium	aerobic
Desulfallas	anaerobic
Desulfarculus	anaerobic
Desulfatiferula	anaerobic
Desulfatiglans	anaerobic
Desulfatirhabdium	anaerobic
Desulfatitalea	anaerobic
Desulfobotulus	anaerobic
Desulfoconvexum	anaerobic
Desulfocucumis	anaerobic
Desulfofarcimen	anaerobic
Desulfofundulus	anaerobic
Desulfohalotomaculum	anaerobic
Desulfoluna	anaerobic
Desulfonatronobacter	anaerobic
Desulfopila	anaerobic
Desulfoplanes	anaerobic
Desulfoprunum	anaerobic
Desulforegula	anaerobic
Desulfosalsimonas	anaerobic
Desulfosoma	anaerobic
Desulfothermus	anaerobic
Desulfovirgula	anaerobic
Dethiobacter	anaerobic
Devriesea 	facultatively anaerobic
Diaminobutyricimonas	aerobic
Effusibacillus 	aerobic
Elioraea	aerobic
Epibacterium	aerobic
Ercella	anaerobic
Extibacter	anaerobic
Flavimaricola	aerobic
Flintibacter	anaerobic
Fonticella	anaerobic
Fuchsiella	anaerobic
Fusicatenibacter	anaerobic
Gaiella	aerobic
Galbitalea	aerobic
Geothermomicrobium	aerobic
Glaciibacter	aerobic
Glaciihabitans	aerobic
Granulicella	aerobic
Gryllotalpicola	aerobic
Halalkalicoccus	aerobic
Halanaerobaculum	anaerobic
Haloarchaeobius	aerobic
Haloimpatiens	anaerobic
Haloparvum	anaerobic
Halopiger	aerobic
Haloplasma	anaerobic
Haloprofundus	anaerobic
Halostagnicola	aerobic
Halostella 	aerobic
Halostella 	anaerobic
Halotalea	facultatively anaerobic
Halovarius	aerobic
Halovenus	aerobic
Herbiconiux	aerobic
Herminiimonas	aerobic
Hwanghaeicola	aerobic
Hydrotalea	aerobic
Ignavibacterium	facultatively anaerobic
Actinotalea	facultatively anaerobic
Demequina	aerobic
Aquabacterium	anaerobic
Methanocalculus	anaerobic
Ideonella 	aerobic
Streptacidiphilus	aerobic
Methylopila	aerobic
Xylophilus	aerobic
Tolumonas 	aerobic
Tolumonas 	anaerobic
Sphaerotilus	aerobic
Tepidimonas	aerobic
Catenococcus 	facultatively anaerobic
Morococcus	aerobic
Intestinimonas	anaerobic
Jeotgalibaca	facultatively anaerobic
Jeotgalicoccus	facultatively anaerobic
Kinneretia	aerobic
Larsenimonas	aerobic
Leptolinea 	anaerobic
Levilinea	anaerobic
Longibacter	facultatively anaerobic
Longicatena	anaerobic
Luteitalea	aerobic
Lysinimonas	aerobic
Mangrovibacter	facultatively anaerobic
Marinicella	aerobic
Marinicrinis 	facultatively anaerobic
Melioribacter 	facultatively anaerobic
Methanotorris	anaerobic
Methyloparacoccus	aerobic
Mobilitalea	anaerobic
Modicisalibacter	aerobic
Muribaculum	anaerobic
Muricomes	anaerobic
Naasia	aerobic
Natranaerobaculum	anaerobic
Natronotalea 	aerobic
Nitrosarchaeum	aerobic
Occallatibacter	aerobic
Oceanivirga	anaerobic
Orbus 	facultatively anaerobic
Ornatilinea	anaerobic
Paenalcaligenes	aerobic
Paeniglutamicibacter 	aerobic
Paludibaculum	facultatively anaerobic
Paludifilum	aerobic
Pelagirhabdus	facultatively anaerobic
Pelolinea	anaerobic
Pistricoccus	facultatively anaerobic
Polygonibacillus	anaerobic
Proteiniborus 	anaerobic
Pseudaestuariivita	aerobic
Pseudogracilibacillus	facultatively anaerobic
Pullulanibacillus	aerobic
Rhabdanaerobium	anaerobic
Rhizomicrobium	facultatively anaerobic
Robinsoniella	anaerobic
Rubritepida	aerobic
Rudaibacter	aerobic
Ruthenibacterium	anaerobic
Salinarimonas	facultatively anaerobic
Salinirussus	aerobic
Salinisphaera 	aerobic
Salinisphaera 	anaerobic
Salipaludibacillus 	facultatively anaerobic
Saliphagus	aerobic
Salirhabdus	aerobic
Salisaeta	aerobic
Sciscionella	aerobic
Silvibacterium	aerobic
Sinibacillus	facultatively anaerobic
Spiribacter	aerobic
Sporosalibacterium	anaerobic
Stenotrophobacter	aerobic
Sulfuricella 	facultatively anaerobic
Syntrophaceticus	anaerobic
Tellurimicrobium	aerobic
Telmatobacter 	facultatively anaerobic
Tepidamorphus	aerobic
Tepidanaerobacter	anaerobic
Tepidicella	aerobic
Tepidimicrobium	anaerobic
Tepidisphaera	facultatively anaerobic
Terracidiphilus	aerobic
Terrimicrobium 	aerobic
Texcoconibacillus 	aerobic
Thermodesulfitimonas	anaerobic
Thermoflexus 	facultatively anaerobic
Thermolongibacillus	aerobic
Thermotomaculum	anaerobic
Tistlia	aerobic
Truepera	aerobic
Umboniibacter	aerobic
Vicinamibacter	aerobic
