Taxon_name	Attribute
Abiotrophia	gram stain positive
Acanthopleuribacter	gram stain negative
Acaricomes	gram stain positive
Acetanaerobacterium	gram stain positive
Acetatifactor	gram stain positive
Acetivibrio	gram stain negative
Acetoanaerobium	gram stain negative
Acetobacter	gram stain negative
Acetobacterium	gram stain positive
Acetofilamentum	gram stain negative
Acetohalobium	gram stain negative
Acetomicrobium	gram stain negative
Acetonema	gram stain negative
Acetothermus	gram stain negative
Achromatium	gram stain negative
Achromobacter	gram stain negative
Acidaminobacter	gram stain negative
Acidaminococcus	gram stain negative
Acidianus	gram stain negative
Acidicapsa	gram stain negative
Acidiphilium	gram stain negative
Acidipila	gram stain negative
Acidisphaera	gram stain negative
Acidithiobacillus	gram stain negative
Acidobacterium	gram stain negative
Acidocella	gram stain negative
Acidomonas	gram stain negative
Acidovorax	gram stain negative
Acinetobacter	gram stain negative
Acrocarpospora	gram stain positive
Actinoalloteichus	gram stain positive
Actinobacillus	gram stain negative
Actinobaculum	gram stain positive
Actinocatenispora	gram stain positive
Actinocorallia	gram stain positive
Actinokineospora	gram stain positive
Actinomadura	gram stain positive
Actinomyces	gram stain positive
Actinomycetospora	gram stain positive
Actinoplanes	gram stain positive
Actinopolymorpha	gram stain positive
Actinopolyspora	gram stain positive
Actinosynnema	gram stain positive
Actinotalea	gram stain positive
Acutalibacter	gram stain negative
Adhaeribacter	gram stain negative
Aequorivita	gram stain negative
Aeriscardovia	gram stain positive
Aerococcus	gram stain positive
Aeromicrobium	gram stain positive
Aeromonas	gram stain negative
Aeropyrum	gram stain negative
Aestuariimicrobium	gram stain positive
Afipia	gram stain negative
Agreia	gram stain positive
Agrobacterium	gram stain negative
Agrococcus	gram stain positive
Agromonas	gram stain negative
Agromyces	gram stain positive
Ahrensia	gram stain negative
Aidingimonas	gram stain negative
Akkermansia	gram stain negative
Albibacter	gram stain negative
Albidovulum	gram stain negative
Alcaligenes	gram stain negative
Alcanivorax	gram stain negative
Alicyclobacillus	gram stain positive
Alishewanella	gram stain negative
Alistipes	gram stain negative
Alkalibacillus	gram stain positive
Alkalibacter	gram stain positive
Alkalibacterium	gram stain positive
Alkalicoccus	gram stain positive
Alkaliflexus	gram stain negative
Alkaliphilus	gram stain positive
Allisonella	gram stain negative
Allobaculum	gram stain positive
Allochromatium	gram stain negative
Allofustis	gram stain positive
Alloiococcus	gram stain positive
Allorhizobium	gram stain negative
Alloscardovia	gram stain positive
Alterococcus	gram stain negative
Alteromonas	gram stain negative
Alysiella	gram stain negative
Amaricoccus	gram stain negative
Aminobacter	gram stain negative
Aminobacterium	gram stain negative
Aminomonas	gram stain negative
Ammonifex	gram stain negative
Ammoniphilus	gram stain positive
Amnibacterium	gram stain positive
Amphibacillus	gram stain positive
Amycolatopsis	gram stain positive
Anaeroarcus	gram stain negative
Anaerobacter	gram stain positive
Anaerobaculum	gram stain negative
Anaerobiospirillum	gram stain negative
Anaerobium	gram stain positive
Anaerococcus	gram stain positive
Anaerocolumna	gram stain positive
Anaerofustis	gram stain positive
Anaeroglobus	gram stain negative
Anaerolinea	gram stain negative
Anaeromusa	gram stain negative
Anaeroplasma	gram stain negative
Anaerorhabdus	gram stain negative
Anaerosinus	gram stain negative
Anaerosporomusa	gram stain negative
Anaerostipes	gram stain positive
Anaerotaenia	gram stain positive
Anaerotruncus	gram stain positive
Anaerovibrio	gram stain negative
Anaplasma	gram stain negative
Ancalochloris	gram stain negative
Ancylobacter	gram stain negative
Aneurinibacillus	gram stain positive
Angustibacter	gram stain positive
Annwoodia	gram stain negative
Anoxybacillus	gram stain positive
Anoxynatronum	gram stain positive
Antarctobacter	gram stain negative
Aquabacter	gram stain negative
Aquabacterium	gram stain negative
Aquamicrobium	gram stain negative
Aquaspirillum	gram stain negative
Aquibacillus	gram stain positive
Aquicella	gram stain negative
Aquifex	gram stain negative
Aquiflexum	gram stain negative
Arcanobacterium	gram stain positive
Archaeoglobus	gram stain negative
Arcobacter	gram stain negative
Arenicella	gram stain negative
Arenimicrobium	gram stain negative
Arhodomonas	gram stain negative
Aridibacter	gram stain negative
Arsenicicoccus	gram stain positive
Arsenophonus	gram stain negative
Asanoa	gram stain positive
Atopobacter	gram stain positive
Atopobium	gram stain positive
Atopococcus	gram stain positive
Atopostipes	gram stain positive
Auraticoccus	gram stain positive
Aureispira	gram stain negative
Azoarcus	gram stain negative
Azomonas	gram stain negative
Azonexus	gram stain negative
Azorhizobium	gram stain negative
Azospira	gram stain negative
Azospirillum	gram stain negative
Azovibrio	gram stain negative
Bacillus	gram stain positive
Bacteroides	gram stain negative
Baia	gram stain positive
Balneatrix	gram stain negative
Barnesiella	gram stain negative
Bartonella	gram stain negative
Basfia	gram stain negative
Bauldia	gram stain negative
Bdellovibrio	gram stain negative
Beggiatoa	gram stain negative
Beijerinckia	gram stain negative
Belliella	gram stain negative
Bellilinea	gram stain negative
Bergeyella	gram stain negative
Beutenbergia	gram stain positive
Bifidobacterium	gram stain positive
Bilophila	gram stain negative
Blastobacter	gram stain negative
Blastocatella	gram stain negative
Blastochloris	gram stain negative
Blastococcus	gram stain positive
Blastomonas	gram stain negative
Bogoriella	gram stain positive
Bordetella	gram stain negative
Borrelia	gram stain negative
Bosea	gram stain negative
Brachybacterium	gram stain positive
Brachymonas	gram stain negative
Brachyspira	gram stain negative
Bradyrhizobium	gram stain negative
Brenneria	gram stain negative
Brevibacterium	gram stain positive
Brevitalea	gram stain negative
Brevundimonas	gram stain negative
Brochothrix	gram stain positive
Brockia	gram stain positive
Brooklawnia	gram stain positive
Brucella	gram stain negative
Brumimicrobium	gram stain negative
Bryantella	gram stain positive
Bryobacter	gram stain negative
Bryocella	gram stain negative
Buchnera	gram stain negative
Budvicia	gram stain negative
Bulleidia	gram stain positive
Burkholderia	gram stain negative
Buttiauxella	gram stain negative
Butyrivibrio	gram stain negative
Caenibacillus	gram stain positive
Calderihabitans	gram stain negative
Calderobacterium	gram stain negative
Caldicellulosiruptor	gram stain negative
Caldisericum	gram stain negative
Caloranaerobacter	gram stain negative
Caloribacterium	gram stain positive
Calymmatobacterium	gram stain negative
Caminicella	gram stain negative
Campylobacter	gram stain negative
Candidatus Xiphinematobacter	gram stain negative
Canibacter	gram stain positive
Capnocytophaga	gram stain negative
Carbophilus	gram stain negative
Carboxydocella	gram stain positive
Carboxydothermus	gram stain positive
Cardiobacterium	gram stain negative
Carnimonas	gram stain negative
Carnobacterium	gram stain positive
Caryophanon	gram stain positive
Catellatospora	gram stain positive
Catenibacterium	gram stain positive
Catenococcus	gram stain negative
Catenulispora	gram stain positive
Catenuloplanes	gram stain positive
Catonella	gram stain negative
Caviibacter	gram stain negative
Cecembia	gram stain negative
Cedecea	gram stain negative
Celeribacter	gram stain negative
Cellulomonas	gram stain positive
Cellulophaga	gram stain negative
Cellulosilyticum	gram stain positive
Cellulosimicrobium	gram stain positive
Cellvibrio	gram stain negative
Centipeda	gram stain negative
Cephaloticoccus	gram stain negative
Cerasibacillus	gram stain positive
Cerasicoccus	gram stain negative
Cetobacterium	gram stain negative
Chelatobacter	gram stain negative
Chelatococcus	gram stain negative
Chitinophaga	gram stain negative
Chloracidobacterium	gram stain negative
Chlorobium	gram stain negative
Chloroflexus	gram stain negative
Chloroherpeton	gram stain negative
Chromatium	gram stain negative
Chromobacterium	gram stain negative
Chromohalobacter	gram stain negative
Chryseobacterium	gram stain negative
Chryseoglobus	gram stain positive
Chrysiogenes	gram stain negative
Chthoniobacter	gram stain negative
Chthonomonas	gram stain negative
Citricoccus	gram stain positive
Citrobacter	gram stain negative
Citromicrobium	gram stain negative
Clavibacter	gram stain positive
Cloacibacterium	gram stain negative
Coenonia	gram stain negative
Cognatishimia	gram stain negative
Cohnella	gram stain positive
Collinsella	gram stain positive
Colwellia	gram stain negative
Comamonas	gram stain negative
Compostibacillus	gram stain positive
Compostimonas	gram stain positive
Conexibacter	gram stain positive
Conyzicola	gram stain positive
Coprobacillus	gram stain positive
Coprococcus	gram stain positive
Coprothermobacter	gram stain negative
Coraliomargarita	gram stain negative
Coriobacterium	gram stain positive
Corynebacterium	gram stain positive
Costertonia	gram stain negative
Couchioplanes	gram stain positive
Craurococcus	gram stain negative
Croceibacter	gram stain negative
Croceifilum	gram stain positive
Crocinitomix	gram stain negative
Crossiella	gram stain positive
Cryobacterium	gram stain positive
Cryomorpha	gram stain negative
Cryptanaerobacter	gram stain positive
Cryptobacterium	gram stain positive
Cryptosporangium	gram stain positive
Cuneatibacter	gram stain positive
Cupriavidus	gram stain negative
Curtobacterium	gram stain positive
Cycloclasticus	gram stain negative
Cytophaga	gram stain negative
Dactylosporangium	gram stain positive
Dechloromonas	gram stain negative
Dechlorosoma	gram stain negative
Deferribacter	gram stain negative
Defluvibacter	gram stain negative
Dehalobacter	gram stain negative
Deinococcus	gram stain positive
Delftia	gram stain negative
Demequina	gram stain positive
Demetria	gram stain positive
Dendrosporobacter	gram stain negative
Denitrobacterium	gram stain positive
Dermacoccus	gram stain positive
Dermatophilus	gram stain positive
Derxia	gram stain negative
Desemzia	gram stain positive
Desulfacinum	gram stain negative
Desulfallas	gram stain negative
Desulfarculus	gram stain negative
Desulfatiferula	gram stain negative
Desulfatiglans	gram stain negative
Desulfatirhabdium	gram stain negative
Desulfatitalea	gram stain negative
Desulfobacca	gram stain negative
Desulfobacter	gram stain negative
Desulfobacterium	gram stain negative
Desulfobacula	gram stain negative
Desulfobotulus	gram stain negative
Desulfobulbus	gram stain negative
Desulfocella	gram stain negative
Desulfococcus	gram stain negative
Desulfoconvexum	gram stain negative
Desulfocucumis	gram stain negative
Desulfofaba	gram stain negative
Desulfofarcimen	gram stain negative
Desulfofrigus	gram stain negative
Desulfofustis	gram stain negative
Desulfohalobium	gram stain negative
Desulfohalotomaculum	gram stain negative
Desulfoluna	gram stain negative
Desulfomicrobium	gram stain negative
Desulfomonile	gram stain negative
Desulfonatronobacter	gram stain negative
Desulfonatronovibrio	gram stain negative
Desulfonatronum	gram stain negative
Desulfonema	gram stain negative
Desulfonispora	gram stain positive
Desulfopila	gram stain negative
Desulfoplanes	gram stain negative
Desulfoprunum	gram stain negative
Desulforegula	gram stain negative
Desulforhabdus	gram stain negative
Desulforhopalus	gram stain negative
Desulfosalsimonas	gram stain negative
Desulfosarcina	gram stain negative
Desulfosoma	gram stain negative
Desulfospira	gram stain negative
Desulfosporosinus	gram stain negative
Desulfotalea	gram stain negative
Desulfothermus	gram stain negative
Desulfotignum	gram stain negative
Desulfotomaculum	gram stain positive
Desulfovibrio	gram stain negative
Desulfovirga	gram stain negative
Desulfovirgula	gram stain positive
Desulfurella	gram stain negative
Desulfurispora	gram stain positive
Desulfurobacterium	gram stain negative
Desulfurococcus	gram stain negative
Desulfuromonas	gram stain negative
Desulfuromusa	gram stain negative
Dethiosulfovibrio	gram stain negative
Devosia	gram stain negative
Devriesea	gram stain positive
Dialister	gram stain negative
Diaminobutyricibacter	gram stain positive
Diaminobutyricimonas	gram stain positive
Dichelobacter	gram stain negative
Dichotomicrobium	gram stain negative
Dictyoglomus	gram stain negative
Dietzia	gram stain positive
Dokdonia	gram stain negative
Dolosicoccus	gram stain positive
Dolosigranulum	gram stain positive
Donghaeana	gram stain negative
Dorea	gram stain positive
Duganella	gram stain negative
Dyadobacter	gram stain negative
Dysgonomonas	gram stain negative
Ectothiorhodospira	gram stain negative
Edaphobacter	gram stain negative
Edwardsiella	gram stain negative
Effluviibacter	gram stain negative
Effusibacillus	gram stain positive
Eggerthella	gram stain positive
Ehrlichia	gram stain negative
Eikenella	gram stain negative
Elioraea	gram stain negative
Elizabethkingia	gram stain negative
Elusimicrobium	gram stain negative
Empedobacter	gram stain negative
Emticicia	gram stain negative
Endomicrobium	gram stain negative
Enhydrobacter	gram stain negative
Ensifer	gram stain negative
Enterobacter	gram stain negative
Enterococcus	gram stain positive
Epibacterium	gram stain negative
Epilithonimonas	gram stain negative
Ercella	gram stain negative
Eremococcus	gram stain positive
Erwinia	gram stain negative
Erysipelothrix	gram stain positive
Erythrobacter	gram stain negative
Erythromicrobium	gram stain negative
Erythromonas	gram stain negative
Escherichia	gram stain negative
Eubacterium	gram stain positive
Euzebya	gram stain positive
Ewingella	gram stain negative
Exiguobacterium	gram stain positive
Extibacter	gram stain positive
Fabibacter	gram stain negative
Facklamia	gram stain positive
Faecalibacterium	gram stain negative
Falcatimonas	gram stain negative
Fastidiosipila	gram stain positive
Fermentibacillus	gram stain positive
Ferrimicrobium	gram stain negative
Ferrimonas	gram stain negative
Ferrithrix	gram stain negative
Fervidobacterium	gram stain negative
Filibacter	gram stain negative
Filobacillus	gram stain positive
Filomicrobium	gram stain negative
Finegoldia	gram stain positive
Flammeovirga	gram stain negative
Flavimaricola	gram stain negative
Flaviramulus	gram stain negative
Flavobacterium	gram stain negative
Flectobacillus	gram stain negative
Flexistipes	gram stain negative
Flexithrix	gram stain negative
Flintibacter	gram stain negative
Fluviicola	gram stain negative
Fodinicola	gram stain positive
Formosa	gram stain negative
Francisella	gram stain negative
Frateuria	gram stain negative
Friedmanniella	gram stain positive
Frigoribacterium	gram stain positive
Frondihabitans	gram stain positive
Fuchsiella	gram stain negative
Fusibacter	gram stain positive
Fusicatenibacter	gram stain positive
Fusobacterium	gram stain negative
Gaetbulibacter	gram stain negative
Gaiella	gram stain negative
Galbitalea	gram stain positive
Gallicola	gram stain positive
Gallionella	gram stain negative
Garciella	gram stain positive
Gardnerella	gram stain negative
Gelidibacter	gram stain negative
Gelria	gram stain positive
Gemella	gram stain positive
Gemmata	gram stain negative
Gemmatimonas	gram stain negative
Gemmobacter	gram stain negative
Geobacillus	gram stain positive
Geobacter	gram stain negative
Georgenia	gram stain positive
Geothermomicrobium	gram stain positive
Geotoga	gram stain negative
Geovibrio	gram stain negative
Gillisia	gram stain negative
Glaciecola	gram stain negative
Glaciibacter	gram stain positive
Glaciihabitans	gram stain positive
Globicatella	gram stain positive
Gluconacetobacter	gram stain negative
Gluconobacter	gram stain negative
Glycomyces	gram stain positive
Goodfellowiella	gram stain positive
Gracilibacillus	gram stain positive
Gracilibacter	gram stain positive
Granulicatella	gram stain positive
Granulicella	gram stain negative
Granulicoccus	gram stain positive
Gryllotalpicola	gram stain positive
Guggenheimella	gram stain positive
Gulosibacter	gram stain positive
Haemophilus	gram stain negative
Hafnia	gram stain negative
Hahella	gram stain negative
Haladaptatus	gram stain negative
Halalkalicoccus	gram stain negative
Halanaerobacter	gram stain negative
Halanaerobium	gram stain negative
Halapricum	gram stain negative
Halarchaeum	gram stain negative
Halarsenatibacter	gram stain negative
Haliscomenobacter	gram stain negative
Ruania	gram stain positive
Haloactinopolyspora	gram stain positive
Haloactinospora	gram stain positive
Haloarchaeobius	gram stain negative
Haloarcula	gram stain negative
Halobacillus	gram stain positive
Halobacterium	gram stain negative
Halobacteroides	gram stain negative
Halobaculum	gram stain negative
Halobellus	gram stain negative
Halocalculus	gram stain negative
Halocella	gram stain negative
Halochromatium	gram stain negative
Haloechinothrix	gram stain positive
Haloferax	gram stain negative
Halogeometricum	gram stain negative
Haloglycomyces	gram stain positive
Halogranum	gram stain negative
Halolactibacillus	gram stain positive
Halolamina	gram stain negative
Halomicroarcula	gram stain negative
Halomicrobium	gram stain negative
Halomonas	gram stain negative
Halonatronum	gram stain negative
Halopenitus	gram stain negative
Halopiger	gram stain negative
Haloplasma	gram stain negative
Haloprofundus	gram stain negative
Halorhabdus	gram stain negative
Halorhodospira	gram stain negative
Halorientalis	gram stain negative
Halorubellus	gram stain negative
Halorubrum	gram stain negative
Halorussus	gram stain negative
Halosarcina	gram stain negative
Halosiccatus	gram stain negative
Halostagnicola	gram stain negative
Halostella	gram stain negative
Halotalea	gram stain negative
Haloterrigena	gram stain negative
Halothermothrix	gram stain negative
Halothiobacillus	gram stain negative
Halovarius	gram stain negative
Halovenus	gram stain negative
Helcococcus	gram stain positive
Helicobacter	gram stain negative
Heliothrix	gram stain negative
Herbaspirillum	gram stain negative
Herbiconiux	gram stain positive
Herbidospora	gram stain positive
Herminiimonas	gram stain negative
Herpetosiphon	gram stain negative
Hespellia	gram stain positive
Hippea	gram stain negative
Hirschia	gram stain negative
Holdemania	gram stain positive
Holophaga	gram stain negative
Homoserinibacter	gram stain positive
Humibacter	gram stain positive
Humicoccus	gram stain positive
Humihabitans	gram stain positive
Hwanghaeicola	gram stain negative
Hydrogenobacter	gram stain negative
Hydrogenophaga	gram stain negative
Hydrogenophilus	gram stain negative
Hydrogenovibrio	gram stain negative
Hydrotalea	gram stain negative
Hymenobacter	gram stain negative
Hyperthermus	gram stain negative
Hyphomicrobium	gram stain negative
Hyphomonas	gram stain negative
Iamia	gram stain positive
Ideonella	gram stain negative
Idiomarina	gram stain negative
Ignavibacterium	gram stain negative
Ignavigranum	gram stain positive
Ignicoccus	gram stain negative
Intestinimonas	gram stain positive
Intrasporangium	gram stain positive
Iodobacter	gram stain negative
Isochromatium	gram stain negative
Isoptericola	gram stain positive
Janibacter	gram stain positive
Janthinobacterium	gram stain negative
Jeotgalibaca	gram stain positive
Jeotgalicoccus	gram stain positive
Jiangella	gram stain positive
Johnsonella	gram stain negative
Jonesia	gram stain positive
Kaistella	gram stain negative
Ketogulonicigenium	gram stain negative
Kibdelosporangium	gram stain positive
Kineococcus	gram stain positive
Kineosphaera	gram stain positive
Kineosporia	gram stain positive
Kingella	gram stain negative
Kinneretia	gram stain negative
Klebsiella	gram stain negative
Kluyvera	gram stain negative
Knoellia	gram stain positive
Kocuria	gram stain positive
Kordia	gram stain negative
Kribbella	gram stain positive
Kribbia	gram stain positive
Krokinobacter	gram stain negative
Kutzneria	gram stain positive
Kytococcus	gram stain positive
Labedella	gram stain positive
Laceyella	gram stain positive
Lachnobacterium	gram stain positive
Lacinutrix	gram stain negative
Lactobacillus	gram stain positive
Lactococcus	gram stain positive
Lactovum	gram stain positive
Lamprobacter	gram stain negative
Lamprocystis	gram stain negative
Lampropedia	gram stain negative
Lapillicoccus	gram stain positive
Larkinella	gram stain negative
Larsenimonas	gram stain negative
Lautropia	gram stain negative
Lawsonia	gram stain negative
Leadbetterella	gram stain negative
Lentzea	gram stain positive
Leclercia	gram stain negative
Leifsonia	gram stain positive
Leminorella	gram stain negative
Lentisphaera	gram stain negative
Leptolinea	gram stain negative
Leptonema	gram stain negative
Leptospira	gram stain negative
Leptospirillum	gram stain negative
Leptothrix	gram stain negative
Leptotrichia	gram stain negative
Leucobacter	gram stain positive
Leucothrix	gram stain negative
Levilinea	gram stain negative
Lewinella	gram stain negative
Lishizhenia	gram stain negative
Listeria	gram stain positive
Longibacter	gram stain negative
Longicatena	gram stain positive
Longilinea	gram stain negative
Longispora	gram stain positive
Luedemannella	gram stain positive
Luteimonas	gram stain negative
Luteitalea	gram stain negative
Luteococcus	gram stain positive
Lutibacter	gram stain negative
Lutispora	gram stain negative
Lysinimonas	gram stain positive
Lysobacter	gram stain negative
Lyticum	gram stain negative
Macrococcus	gram stain positive
Macromonas	gram stain negative
Mageeibacillus	gram stain positive
Magnetospirillum	gram stain negative
Mahella	gram stain positive
Malonomonas	gram stain negative
Mangrovibacter	gram stain negative
Mannheimia	gram stain negative
Marichromatium	gram stain negative
Marinactinospora	gram stain positive
Marinibacillus	gram stain positive
Marinicella	gram stain negative
Mariniflexile	gram stain negative
Marinilabilia	gram stain negative
Marinilactibacillus	gram stain positive
Marinobacter	gram stain negative
Marinobacterium	gram stain negative
Marinococcus	gram stain positive
Marinomonas	gram stain negative
Marmoricola	gram stain positive
Marvinbryantia	gram stain positive
Massilia	gram stain negative
Mechercharimyces	gram stain positive
Megasphaera	gram stain negative
Meiothermus	gram stain negative
Melghiribacillus	gram stain positive
Melioribacter	gram stain negative
Melissococcus	gram stain positive
Meniscus	gram stain negative
Mesophilobacter	gram stain negative
Mesorhizobium	gram stain negative
Metallosphaera	gram stain negative
Metascardovia	gram stain positive
Methanobacterium	gram stain positive
Methanobrevibacter	gram stain positive
Methanocaldococcus	gram stain negative
Methanocorpusculum	gram stain negative
Methanoculleus	gram stain negative
Methanofollis	gram stain negative
Methanogenium	gram stain negative
Methanohalophilus	gram stain negative
Methanolacinia	gram stain negative
Methanolobus	gram stain negative
Methanomassiliicoccus	gram stain positive
Methanomicrobium	gram stain negative
Methanoplanus	gram stain negative
Methanopyrus	gram stain positive
Methanosaeta	gram stain negative
Methanosphaera	gram stain positive
Methanosphaerula	gram stain positive
Methanospirillum	gram stain negative
Methanothermobacter	gram stain positive
Methanothermococcus	gram stain negative
Methanothermus	gram stain positive
Methylarcula	gram stain negative
Methylobacillus	gram stain negative
Methylobacter	gram stain negative
Methylobacterium	gram stain negative
Methylocaldum	gram stain negative
Methylocapsa	gram stain negative
Methylocella	gram stain negative
Methylococcus	gram stain negative
Methyloferula	gram stain negative
Methylogaea	gram stain negative
Methylohalobius	gram stain negative
Methylomarinovum	gram stain negative
Methylomarinum	gram stain negative
Methylomicrobium	gram stain negative
Methylomonas	gram stain negative
Methyloparacoccus	gram stain negative
Methylophaga	gram stain negative
Methylophilus	gram stain negative
Methylopila	gram stain negative
Methylorhabdus	gram stain negative
Methylorosula	gram stain negative
Methylosarcina	gram stain negative
Methylosphaera	gram stain negative
Methylothermus	gram stain negative
Methylovirgula	gram stain negative
Methylovorus	gram stain negative
Micavibrio	gram stain negative
Microbacterium	gram stain positive
Microbispora	gram stain positive
Microbulbifer	gram stain negative
Microcella	gram stain positive
Micrococcus	gram stain positive
Microlunatus	gram stain positive
Micromonospora	gram stain positive
Micropepsis	gram stain negative
Micropruina	gram stain positive
Microterricola	gram stain positive
Microtetraspora	gram stain positive
Microvirgula	gram stain negative
Miniimonas	gram stain positive
Mitsuokella	gram stain negative
Mobilitalea	gram stain positive
Mobiluncus	gram stain negative
Modestobacter	gram stain positive
Modicisalibacter	gram stain negative
Moellerella	gram stain negative
Mogibacterium	gram stain positive
Moorella	gram stain positive
Moraxella	gram stain negative
Morganella	gram stain negative
Moritella	gram stain negative
Morococcus	gram stain negative
Moryella	gram stain positive
Muribaculum	gram stain negative
Muricauda	gram stain negative
Muricomes	gram stain positive
Myceligenerans	gram stain positive
Mycetocola	gram stain positive
Mycobacterium	gram stain positive
Mycoplana	gram stain negative
Mycoplasma	gram stain negative
Myroides	gram stain negative
Naasia	gram stain positive
Nakamurella	gram stain positive
Nanoarchaeum	gram stain negative
Natranaerobaculum	gram stain positive
Natrialba	gram stain negative
Natrinema	gram stain negative
Natroniella	gram stain negative
Natronincola	gram stain positive
Natronoarchaeum	gram stain negative
Natronobacterium	gram stain negative
Natronolimnobius	gram stain negative
Natronomonas	gram stain negative
Natronorubrum	gram stain negative
Neisseria	gram stain negative
Neorickettsia	gram stain negative
Nesterenkonia	gram stain positive
Nevskia	gram stain negative
Nitriliruptor	gram stain positive
Nitrobacter	gram stain negative
Nitrococcus	gram stain negative
Nitrosococcus	gram stain negative
Nitrosolobus	gram stain negative
Nitrosomonas	gram stain negative
Nitrosospira	gram stain negative
Nitrosovibrio	gram stain negative
Nitrospina	gram stain negative
Nitrospira	gram stain negative
Nocardioides	gram stain positive
Nocardiopsis	gram stain positive
Nonlabens	gram stain negative
Nonomuraea	gram stain positive
Obesumbacterium	gram stain negative
Occallatibacter	gram stain negative
Oceanimonas	gram stain negative
Oceanirhabdus	gram stain positive
Oceanivirga	gram stain negative
Oceanobacillus	gram stain positive
Oceanospirillum	gram stain negative
Ochrobactrum	gram stain negative
Octadecabacter	gram stain negative
Oenococcus	gram stain positive
Oerskovia	gram stain positive
Okibacterium	gram stain positive
Oligella	gram stain negative
Olleya	gram stain negative
Olsenella	gram stain positive
Opitutus	gram stain negative
Orbus	gram stain negative
Orenia	gram stain negative
Oribacterium	gram stain positive
Ornatilinea	gram stain negative
Ornithinicoccus	gram stain positive
Ornithinimicrobium	gram stain positive
Ornithobacterium	gram stain negative
Oryzihumus	gram stain positive
Owenweeksia	gram stain negative
Oxalobacter	gram stain negative
Oxalophagus	gram stain positive
Oxobacter	gram stain positive
Paenalcaligenes	gram stain negative
Paenochrobactrum	gram stain negative
Palaeococcus	gram stain negative
Paludibacter	gram stain negative
Paludibaculum	gram stain negative
Pandoraea	gram stain negative
Pantoea	gram stain negative
Papillibacter	gram stain positive
Paracoccus	gram stain negative
Paracraurococcus	gram stain negative
Paralactobacillus	gram stain positive
Paraliobacillus	gram stain positive
Parascardovia	gram stain positive
Parasporobacterium	gram stain negative
Parvimonas	gram stain positive
Pasteurella	gram stain negative
Pasteuria	gram stain positive
Patulibacter	gram stain positive
Paucimonas	gram stain negative
Pectinatus	gram stain negative
Pectobacterium	gram stain negative
Pedobacter	gram stain negative
Pedomicrobium	gram stain negative
Pelagicoccus	gram stain negative
Pelagirhabdus	gram stain positive
Pelistega	gram stain negative
Pelobacter	gram stain negative
Pelodictyon	gram stain negative
Pelolinea	gram stain negative
Pelotomaculum	gram stain positive
Peptococcus	gram stain positive
Peptoniphilus	gram stain positive
Peptostreptococcus	gram stain positive
Persicivirga	gram stain negative
Persicobacter	gram stain negative
Petrimonas	gram stain negative
Petrotoga	gram stain negative
Pfennigia	gram stain negative
Phaeospirillum	gram stain negative
Phascolarctobacterium	gram stain negative
Phenylobacterium	gram stain negative
Phocoenobacter	gram stain negative
Photobacterium	gram stain negative
Photorhabdus	gram stain negative
Phycicoccus	gram stain positive
Phycicola	gram stain positive
Phycisphaera	gram stain negative
Phyllobacterium	gram stain negative
Phytohabitans	gram stain positive
Phytomonospora	gram stain positive
Pigmentiphaga	gram stain negative
Pilimelia	gram stain positive
Pirellula	gram stain negative
Piscirickettsia	gram stain negative
Pistricoccus	gram stain negative
Planctomyces	gram stain negative
Planifilum	gram stain positive
Planobispora	gram stain positive
Planomonospora	gram stain positive
Planotetraspora	gram stain positive
Plantactinospora	gram stain positive
Plantibacter	gram stain positive
Plesiomonas	gram stain negative
Polaribacter	gram stain negative
Polaromonas	gram stain negative
Polygonibacillus	gram stain positive
Polymorphospora	gram stain positive
Pontibaca	gram stain negative
Pontibacillus	gram stain positive
Pontimonas	gram stain positive
Porphyrobacter	gram stain negative
Porphyromonas	gram stain negative
Porticoccus	gram stain negative
Pragia	gram stain negative
Prauserella	gram stain positive
Prevotella	gram stain negative
Promicromonospora	gram stain positive
Propionibacter	gram stain negative
Propionibacterium	gram stain positive
Propionicicella	gram stain positive
Propionicimonas	gram stain positive
Propioniferax	gram stain positive
Propionimicrobium	gram stain positive
Propionispira	gram stain negative
Propionispora	gram stain negative
Propionivibrio	gram stain negative
Prosthecobacter	gram stain negative
Prosthecochloris	gram stain negative
Prosthecomicrobium	gram stain negative
Proteiniborus	gram stain positive
Proteiniphilum	gram stain negative
Proteus	gram stain negative
Providencia	gram stain negative
Pseudaestuariivita	gram stain negative
Pseudaminobacter	gram stain negative
Pseudoalteromonas	gram stain negative
Pseudobutyrivibrio	gram stain negative
Pseudochrobactrum	gram stain negative
Pseudoclavibacter	gram stain positive
Pseudomonas	gram stain negative
Pseudonocardia	gram stain positive
Pseudoramibacter	gram stain positive
Pseudoxanthomonas	gram stain negative
Psychrobacter	gram stain negative
Psychroflexus	gram stain negative
Psychromonas	gram stain negative
Psychroserpens	gram stain negative
Pullulanibacillus	gram stain positive
Puniceicoccus	gram stain negative
Pyrinomonas	gram stain negative
Pyrobaculum	gram stain negative
Pyrococcus	gram stain negative
Pyrolobus	gram stain negative
Quadrisphaera	gram stain positive
Quinella	gram stain negative
Rahnella	gram stain negative
Ralstonia	gram stain negative
Rarobacter	gram stain positive
Rathayibacter	gram stain positive
Renibacterium	gram stain positive
Rhabdanaerobium	gram stain positive
Rhabdochromatium	gram stain negative
Rhizobacter	gram stain negative
Rhizobium	gram stain negative
Rhizocola	gram stain positive
Rhizomicrobium	gram stain negative
Rhodanobacter	gram stain negative
Rhodobaca	gram stain negative
Rhodobacter	gram stain negative
Rhodobium	gram stain negative
Rhodoblastus	gram stain negative
Rhodocista	gram stain negative
Rhodocyclus	gram stain negative
Rhodoferax	gram stain negative
Rhodoglobus	gram stain positive
Rhodomicrobium	gram stain negative
Rhodonellum	gram stain negative
Rhodopila	gram stain negative
Rhodoplanes	gram stain negative
Rhodopseudomonas	gram stain negative
Rhodospira	gram stain negative
Rhodospirillum	gram stain negative
Rhodothalassium	gram stain negative
Rhodothermus	gram stain negative
Rhodovibrio	gram stain negative
Rhodovulum	gram stain negative
Rickettsia	gram stain negative
Rickettsiella	gram stain negative
Riemerella	gram stain negative
Rikenella	gram stain negative
Robiginitalea	gram stain negative
Robinsoniella	gram stain positive
Roseateles	gram stain negative
Roseburia	gram stain negative
Roseibium	gram stain negative
Roseinatronobacter	gram stain negative
Roseivivax	gram stain negative
Roseobacter	gram stain negative
Roseococcus	gram stain negative
Roseomonas	gram stain negative
Roseospira	gram stain negative
Roseospirillum	gram stain negative
Roseovarius	gram stain negative
Rothia	gram stain positive
Rubrimonas	gram stain negative
Rubritalea	gram stain negative
Rubritepida	gram stain negative
Rubrivivax	gram stain negative
Rubrobacter	gram stain positive
Rudaibacter	gram stain positive
Ruegeria	gram stain negative
Rugosimonospora	gram stain positive
Ruminobacter	gram stain negative
Ruminococcus	gram stain positive
Runella	gram stain negative
Ruthenibacterium	gram stain negative
Saccharococcus	gram stain positive
Saccharofermentans	gram stain positive
Saccharomonospora	gram stain positive
Saccharopolyspora	gram stain positive
Saccharothrix	gram stain positive
Sagittula	gram stain negative
Salana	gram stain positive
Salarchaeum	gram stain negative
Salegentibacter	gram stain negative
Salinarchaeum	gram stain negative
Salinarimonas	gram stain negative
Salinibacter	gram stain negative
Salinibacterium	gram stain positive
Salinicoccus	gram stain positive
Salinicola	gram stain negative
Salinigranum	gram stain negative
Salinirubrum	gram stain negative
Salinirussus	gram stain negative
Salinisphaera	gram stain negative
Salinispora	gram stain positive
Salinivenus	gram stain negative
Salinivibrio	gram stain negative
Salipaludibacillus	gram stain positive
Saliphagus	gram stain negative
Salirhabdus	gram stain positive
Salisaeta	gram stain negative
Salmonella	gram stain negative
Sandaracinobacter	gram stain negative
Sandarakinotalea	gram stain negative
Saprospira	gram stain negative
Sarcina	gram stain positive
Scardovia	gram stain positive
Schineria	gram stain negative
Schlesneria	gram stain negative
Schwartzia	gram stain negative
Sciscionella	gram stain positive
Sebaldella	gram stain negative
Sedimentibacter	gram stain positive
Sediminicola	gram stain negative
Seinonella	gram stain positive
Sejongia	gram stain negative
Selenihalanaerobacter	gram stain negative
Selenomonas	gram stain negative
Seliberia	gram stain negative
Serinibacter	gram stain positive
Serinicoccus	gram stain positive
Serpens	gram stain negative
Serratia	gram stain negative
Shewanella	gram stain negative
Shigella	gram stain negative
Shimazuella	gram stain positive
Shuttleworthia	gram stain positive
Silvibacterium	gram stain negative
Simonsiella	gram stain negative
Singulisphaera	gram stain negative
Sinibacillus	gram stain positive
Sinorhizobium	gram stain negative
Skermanella	gram stain negative
Skermania	gram stain positive
Slackia	gram stain positive
Smaragdicoccus	gram stain positive
Smithella	gram stain negative
Sneathia	gram stain negative
Sodalis	gram stain negative
Soehngenia	gram stain positive
Solirubrobacter	gram stain positive
Solobacterium	gram stain positive
Sphaerisporangium	gram stain positive
Sphaerotilus	gram stain negative
Sphingobacterium	gram stain negative
Sphingomonas	gram stain negative
Sphingopyxis	gram stain negative
Spiribacter	gram stain negative
Spirilliplanes	gram stain positive
Spirillospora	gram stain positive
Spirillum	gram stain negative
Spirosoma	gram stain negative
Sporacetigenium	gram stain positive
Sporanaerobacter	gram stain positive
Sporobacter	gram stain positive
Sporobacterium	gram stain positive
Sporocytophaga	gram stain negative
Sporohalobacter	gram stain negative
Sporolactobacillus	gram stain positive
Sporotomaculum	gram stain positive
Stackebrandtia	gram stain positive
Staleya	gram stain negative
Staphylococcus	gram stain positive
Staphylothermus	gram stain negative
Stappia	gram stain negative
Stella	gram stain negative
Stenothermobacter	gram stain negative
Stenotrophobacter	gram stain negative
Stenotrophomonas	gram stain negative
Stetteria	gram stain negative
Streptacidiphilus	gram stain positive
Streptoalloteichus	gram stain positive
Streptobacillus	gram stain negative
Streptococcus	gram stain positive
Streptomonospora	gram stain positive
Streptomyces	gram stain positive
Streptosporangium	gram stain positive
Stygiolobus	gram stain negative
Subdoligranulum	gram stain negative
Subsaxibacter	gram stain negative
Subsaximicrobium	gram stain negative
Subtercola	gram stain positive
Succiniclasticum	gram stain negative
Succinimonas	gram stain negative
Succinispira	gram stain negative
Succinivibrio	gram stain negative
Sulfitobacter	gram stain negative
Sulfobacillus	gram stain positive
Sulfolobus	gram stain negative
Sulfuricella	gram stain negative
Sulfurisphaera	gram stain negative
Sulfurospirillum	gram stain negative
Sutterella	gram stain negative
Suttonella	gram stain negative
Symbiobacterium	gram stain negative
Synergistes	gram stain negative
Syntrophobacter	gram stain negative
Syntrophobotulus	gram stain positive
Syntrophococcus	gram stain negative
Syntrophomonas	gram stain negative
Syntrophospora	gram stain positive
Syntrophothermus	gram stain negative
Syntrophus	gram stain negative
Tannerella	gram stain negative
Tatumella	gram stain negative
Taylorella	gram stain negative
Telluria	gram stain negative
Tellurimicrobium	gram stain negative
Telmatobacter	gram stain negative
Tenacibaculum	gram stain negative
Tenuibacillus	gram stain positive
Tepidamorphus	gram stain negative
Tepidanaerobacter	gram stain positive
Tepidibacter	gram stain positive
Tepidicella	gram stain negative
Tepidimicrobium	gram stain positive
Tepidimonas	gram stain negative
Terrabacter	gram stain positive
Terracidiphilus	gram stain negative
Terracoccus	gram stain positive
Terriglobus	gram stain negative
Terrimicrobium	gram stain negative
Terrimonas	gram stain negative
Tessaracoccus	gram stain positive
Tetragenococcus	gram stain positive
Tetrasphaera	gram stain positive
Texcoconibacillus	gram stain positive
Thalassobacillus	gram stain positive
Thauera	gram stain negative
Thermacetogenium	gram stain positive
Thermaerobacter	gram stain negative
Thermanaerovibrio	gram stain negative
Thermicanus	gram stain positive
Thermincola	gram stain positive
Thermithiobacillus	gram stain negative
Thermoactinomyces	gram stain positive
Thermoanaerobacter	gram stain positive
Thermoanaerobacterium	gram stain positive
Thermobacillus	gram stain negative
Thermobifida	gram stain positive
Thermobispora	gram stain positive
Thermobrachium	gram stain positive
Thermochromatium	gram stain negative
Thermocladium	gram stain negative
Thermocrinis	gram stain negative
Thermocrispum	gram stain positive
Thermodesulfitimonas	gram stain positive
Thermodesulfobacterium	gram stain negative
Thermodesulfobium	gram stain negative
Thermodesulforhabdus	gram stain negative
Thermodesulfovibrio	gram stain negative
Thermodiscus	gram stain negative
Thermofilum	gram stain negative
Thermoflavimicrobium	gram stain positive
Thermoflexus	gram stain negative
Thermohalobacter	gram stain negative
Thermoleophilum	gram stain negative
Thermolongibacillus	gram stain positive
Thermomicrobium	gram stain negative
Thermomonas	gram stain negative
Thermomonospora	gram stain positive
Thermonema	gram stain negative
Thermoplasma	gram stain negative
Thermopolyspora	gram stain positive
Thermosediminibacter	gram stain positive
Thermosinus	gram stain negative
Thermosipho	gram stain negative
Thermosyntropha	gram stain positive
Thermothrix	gram stain negative
Thermotoga	gram stain negative
Thermotomaculum	gram stain negative
Thermovenabulum	gram stain positive
Thermus	gram stain negative
Thioalkalicoccus	gram stain negative
Thioalkalimicrobium	gram stain negative
Thioalkalivibrio	gram stain negative
Thiobacillus	gram stain negative
Thiocapsa	gram stain negative
Thiococcus	gram stain negative
Thiocystis	gram stain negative
Thiodictyon	gram stain negative
Thioflavicoccus	gram stain negative
Thiohalocapsa	gram stain negative
Thiolamprovum	gram stain negative
Thiomargarita	gram stain negative
Thiomicrospira	gram stain negative
Thiomonas	gram stain negative
Thiopedia	gram stain negative
Thioploca	gram stain negative
Thiorhodococcus	gram stain negative
Thiorhodospira	gram stain negative
Thiorhodovibrio	gram stain negative
Thiospirillum	gram stain negative
Thiothrix	gram stain negative
Tindallia	gram stain positive
Tissierella	gram stain positive
Tistlia	gram stain negative
Tolumonas	gram stain negative
Trabulsiella	gram stain negative
Treponema	gram stain negative
Trichococcus	gram stain positive
Tsukamurella	gram stain positive
Turicella	gram stain positive
Turicibacter	gram stain positive
Turicimonas	gram stain negative
Turneriella	gram stain negative
Umboniibacter	gram stain negative
Umezawaea	gram stain positive
Ureibacillus	gram stain negative
Vagococcus	gram stain positive
Vampirovibrio	gram stain negative
Varibaculum	gram stain positive
Variovorax	gram stain negative
Veillonella	gram stain negative
Verrucomicrobium	gram stain negative
Verrucosispora	gram stain positive
Vibrio	gram stain negative
Vicinamibacter	gram stain negative
Victivallis	gram stain negative
Virgibacillus	gram stain positive
Virgisporangium	gram stain positive
Vitreoscilla	gram stain negative
Wautersiella	gram stain negative
Weeksella	gram stain negative
Weissella	gram stain positive
Wigglesworthia	gram stain negative
Williamsia	gram stain positive
Wolinella	gram stain negative
Xanthomonas	gram stain negative
Xenorhabdus	gram stain negative
Xiangella	gram stain positive
Xylanibacter	gram stain negative
Xylanibacterium	gram stain positive
Xylanimicrobium	gram stain positive
Xylanimonas	gram stain positive
Xylella	gram stain negative
Xylophilus	gram stain negative
Yaniella	gram stain positive
Yeosuana	gram stain negative
Yersinia	gram stain negative
Yimella	gram stain positive
Yokenella	gram stain negative
Yonghaparkia	gram stain positive
Zhihengliuella	gram stain positive
Zhouia	gram stain negative
Zoogloea	gram stain negative
Zymobacter	gram stain negative
Zymomonas	gram stain negative
Zymophilus	gram stain negative
